
Please enter a state abbreviation:
        ak = Alaska
        al = Alabama
        ar = Arkansas
        az = Arizona
        ca = California
        co = Colorado
        ct = Connecticut
        de = Delaware
        fl = Florida
        ga = Georgia
        hi = Hawaii
        ia = Iowa
        id = Idaho
        il = Illinois
        in = Indiana
        ks = Kansas
        ky = Kentucky
        la = Louisiana
        ma = Massachusetts
        md = Maryland
        me = Maine
        mi = Michigan
        mn = Minnesota
        mo = Missouri
        ms = Mississippi
        mt = Montana
        nc = North Carolina
        nd = North Dakota
        ne = Nebraska 
        nh = New Hampshire
        nj = New Jersey
        nm = New Mexico
        nv = Nevada
        ny = New York
        oh = Ohio
        ok = Oklahoma
        or = Oregon
        pa = Pennsylvania
        ri = Rhode Island
        sc = South Carolina
        sd = South Dakota
        tn = Tennessee
        tx = Texas
        ut = Utah
        va = Virginia
        vt = Vermont
        wa = Washington
        wi = Wisconsin
        wv = West Virginia
        wy = Wyoming

Followed by the type of data you would like to see:
	rank = the national ranking of the university
	students = the number of students who attend the university
	tuition = in state and out of state tuition
	acceptance = the acceptance rate for the university

Example: ca tuition

